10
10
2
4
##########
###....###
##......##
#...##...#
#000##...#
#...##...#
#...##...#
##......##
###....###
##########